R 1400 700
NO textures/pink2.xpm
SO textures/sky_copy.XPM
WE textures/rainbow.xpm
EA textures/side.xpm
S textures/lama.XPM
LI textures/mini_heart.xpm
DO textures/tropical.XPM
CO textures/planet_rose.XPM
LU textures/jesus.XPM
F 103,204,250
C 103,204,250

1111111111111111111111111111111
1000000000000000000000000000001
1000000000000011111110000000001
10000000E00000DCCCCCH00U0000001
1000000000000011111110000000001
1000000000000000000000000000001
1111111111111111111111111111111
